round_id,turn,N,Nnf,roundName,first,hole,board,Nsim,prWin,prWinStd,chips,reld,chips_total,pot,bet,cost_on_table,cost_to_call,cost_total,maxBet_all,N_maxBet_all,prWin_adj,limitBet,util_fold,util_call,util_raise_coeff,action,amount,cputime
1,0,4,4,deal,False,♥3 ♦Q,,20000,0.230053571428586,0.4208668740843576,1000,0,3000,0,0,0,870,870,870,1,0.20901022772436814,92.54305366977673,0,-318.2129988076681,-0.5819795445512637,fold,0,0.09613800048828125
2,0,4,4,deal,False,♠8 ♦K,,20000,0.2886666666667008,0.45314260693763575,1000,0,3000,0,0,0,20,20,20,1,0.26600953631981905,122.06152270449746,0,-1.3793324576126658,-0.4679809273603619,fold,0,0.09617185592651367
3,0,4,4,deal,False,♥6 ♠4,,20000,0.1983791666666739,0.39877922826961526,980,0,2980,0,20,20,860,880,880,1,0.17844020525319315,77.05935744007972,-20,-385.3490540265062,-0.6431195894936137,fold,0,0.09310197830200195
4,0,4,4,deal,False,♠2 ♣5,,20000,0.16710178571429407,0.3730667218144607,970,0,2970,0,10,10,349,359,359,1,0.14844844962357104,62.79055223758672,-10,-184.66756626670687,-0.7031031007528579,fold,0,0.09671902656555176
5,0,4,4,deal,False,♣6 ♦7,,20000,0.2282547619047756,0.4197076668022277,970,0,2970,0,0,0,40,40,40,1,0.2072693785646642,90.75860151476402,0,-10.775017622382347,-0.5854612428706716,fold,0,0.09403181076049805
6,0,3,3,deal,False,♥Q ♠6,,20000,0.3442444444443984,0.47512125495873775,930,0,2930,0,40,40,0,40,40,2,0.3204883816964615,148.9423369650082,-40,28.843954352681536,-0.359023236607077,check,0,0.09763813018798828
6,1,3,3,flop,True,♥Q ♠6,♥7 ♦7 ♠4,90,0.3,0.43969686527576396,930,0,2930,40,0,40,40,80,0,3,0.11669697220176639,78.94926148914273,0,-20.161514725699714,-0.7666060555964672,fold,0,1.206247091293335
7,0,3,3,deal,False,♥3 ♥9,,20000,0.294397222222195,0.4557713217942201,910,0,2910,0,20,20,20,40,40,2,0.27160865613248397,121.33137301092329,-20,18.025211858547756,-0.45678268773503206,call,0,0.09604406356811523
7,1,3,3,flop,True,♥3 ♥9,♠6 ♠3 ♣A,94,0.2074468085106383,0.39551726478768734,890,0,2890,40,0,40,40,80,0,3,0.045255499175328284,29.06304572831846,0,-30.948900164934344,-0.9094890016493434,fold,0,1.2126679420471191
8,0,3,3,deal,False,♦J ♥K,,20000,0.4404888888888205,0.49644579528314353,890,0,2890,0,0,0,80,80,80,1,0.4156665991246633,204.28488818295986,0,36.386647754905724,-0.1686668017506734,call,0,0.09897494316101074
8,1,3,2,flop,True,♦J ♥K,♥10 ♦5 ♥8,230,0.21739130434782608,0.41247099915239727,810,0,2810,80,0,80,80,160,0,3,0.05240290468686715,32.84367227336398,0,-59.03883812525314,-0.8951941906262657,fold,0,1.2156140804290771
9,0,3,3,deal,False,♥10 ♠5,,20000,0.2930263888888595,0.45515044139670385,730,0,2730,0,80,80,0,80,80,3,0.2702688668190243,113.16629984970679,-80,64.86452803656583,-0.4594622663619514,check,0,0.0942988395690918
9,1,3,2,flop,True,♥10 ♠5,♣9 ♠Q ♠4,192,0.203125,0.3924955214712647,730,0,2730,80,0,80,80,160,0,3,0.042195085130203314,25.556811398771725,0,-63.121965947918675,-0.9156098297395934,fold,0,1.2127249240875244
10,0,3,3,deal,False,♠9 ♦2,,20000,0.25141527777776723,0.43382673485816364,690,0,2690,0,40,40,40,80,80,2,0.22972394103485905,92.3715280271011,-40,24.322703489760528,-0.5405521179302819,call,0,0.10035300254821777
10,1,3,3,flop,True,♠9 ♦2,♣4 ♥3 ♥8,108,0.1111111111111111,0.31426968052735443,650,0,2650,80,0,80,80,160,0,3,0.0,-0.0,0,-80.0,-1.0,fold,0,1.2158739566802979
11,0,3,3,deal,False,♠Q ♠K,,20000,0.4806263888888164,0.499624522208941,650,0,2650,0,0,0,160,160,160,1,0.45564516277836936,212.02850981151624,0,95.16129115588683,-0.08870967444326128,call,0,0.10183405876159668
11,1,3,2,flop,True,♠Q ♠K,♣7 ♦7 ♣A,210,0.29642857142857143,0.4497873647284768,490,0,2490,160,0,160,160,320,0,3,0.11375567317844226,65.2959321905235,0,-68.9954614572462,-0.7724886536431155,fold,0,1.2155232429504395
12,0,3,2,deal,False,♠5 ♥9,,20000,0.28376111111108565,0.4508222964007967,330,0,2330,0,160,160,0,160,160,2,0.2612199962910458,92.80731855186744,-160,104.48799851641833,-0.4775600074179084,check,0,0.09355401992797852
12,1,3,2,flop,True,♠5 ♥9,♦K ♥3 ♣9,85,0.6,0.48989794855663565,330,0,2330,160,0,160,160,320,0,3,0.4040408205773457,261.8727617714146,0,130.90939081568888,-0.1919183588453086,call,0,1.215447187423706
13,0,3,3,deal,False,♥2 ♠Q,,20000,0.3100972222221872,0.4625331717750314,650,0,2650,0,80,80,80,160,160,2,0.28697056363343565,117.92235545496706,-80,80.70351563472397,-0.4260588727331287,call,0,0.09497213363647461
13,1,3,3,flop,True,♥2 ♠Q,♣8 ♠4 ♥A,96,0.09375,0.2914805954090255,570,0,2570,160,0,160,160,320,0,3,0.0,-0.0,0,-160.0,-1.0,fold,0,1.21073317527771
14,0,3,3,deal,False,♦6 ♣2,,20000,0.22690694444444354,0.4188319269197726,570,0,2570,0,0,0,320,320,320,1,0.2059653480984549,77.9794789821659,0,-89.31881012973051,-0.5880693038030902,fold,0,0.0960540771484375
15,0,3,3,deal,False,♣9 ♦9,,20000,0.5415597222221448,0.49826979588253006,250,0,2250,0,320,320,0,320,320,3,0.5166462324280182,215.20661965387595,-320,495.9803831308975,0.03329246485603643,raise,0,0.10299110412597656
16,0,3,2,deal,False,♥9 ♦9,,20000,0.5415597222221448,0.49826979588253006,1550,0,3550,0,160,160,160,320,320,1,0.5166462324280182,339.5482221205598,-160,253.3169859424146,0.03329246485603643,raise,0,0.09377837181091309
17,0,3,3,deal,False,♦10 ♣K,,20000,0.4353291666666003,0.49580004368289804,2030,0,4030,0,0,0,320,320,320,1,0.4105391644824554,280.23572375107386,0,201.38473889271836,-0.17892167103508916,call,0,0.10228371620178223
17,1,3,3,flop,True,♦10 ♣K,♠10 ♦5 ♠7,216,0.4652777777777778,0.495300055584217,1710,0,3710,320,0,320,640,960,0,3,0.2657606136904941,248.87110849795815,0,-47.3538314701982,-0.46847877261901183,fold,0,1.216352939605713
18,0,3,2,deal,False,♣K ♦A,,20000,0.4936652777777009,0.4999598696839241,1070,0,3070,0,640,640,0,640,640,2,0.4686672842935047,255.41260441290038,-640,749.8676548696075,-0.06266543141299064,check,0,0.09457921981811523
18,1,3,2,flop,True,♣K ♦A,♠5 ♥9 ♣10,95,0.12631578947368421,0.3322049229065159,1070,0,3070,640,0,640,640,1280,0,3,0.0,-0.0,0,-640.0,-1.0,fold,0,1.2146430015563965
19,0,3,3,deal,False,♦10 ♦5,,20000,0.3344722222221802,0.4718056324207424,750,0,2750,0,320,320,320,640,640,2,0.3108819406011431,134.71326046184274,-320,376.3755469465606,-0.3782361187977138,call,0,0.09610104560852051
19,1,3,3,flop,True,♦10 ♦5,♥9 ♣9 ♥4,86,0.19767441860465115,0.3982452044079932,430,0,2430,640,0,640,430,1070,0,3,0.03837633684145386,20.648752842348195,0,-323.31378358075824,-0.9232473263170923,fold,0,1.212421178817749
20,0,3,3,deal,False,♦2 ♠3,,20000,0.2195972222222245,0.41397376995953195,430,0,2430,0,0,0,430,430,640,1,0.1988985337242479,70.898874163281,0,-123.69625806465825,-0.6022029325515041,fold,0,0.09772109985351562
